1711111111111111111;
1911111111111118811;
1666611111111118811;
1111161111111111111;
1111116666111111511;
1111111111665115511;
1112222221115111511;
1111111111115511511;
1111111111111111511;
1111111111155555511;
1111111111111111111;
2111111555111111111;
2211111111111111111;
2221555111111111111;
2222111111111111111;
3322555555555555511;
3323332333233323332;
3233323332333233355;
3355355355255355332;
3233323332333233323;
3323552553553553332;
3233323332333233323;
3355355355255355372;
3233323332333233393;
5555555555555555555;