2812211241122112211;
3731314131313131313;
5555555555522662211;
5555555555513131313;
2112211241122192661;
3134313131313431313;
2112211221422662211;
3131314931313131666;
4192211241166662214;
3131316666313141313;
2666611241124112211;
3141313131313131413;
6666266661926666666;
3131313131313131313;
4112411221122149211;
3191366666666131313;
2142211241122142211;
6666316666393666613;
2112211221122412211;
3131313166666666666;
2142211291124112211;
6666663131313131413;
3131316131343131983;
2112211621122112271;
5555555555555555555;