9999244444444412231;
9779124444444233123;
9779231444441312231;
9779123344431233123;
5555555555555555235;
1233123344421233155;
2312231255555555555;
1233223344412233523;
2313531255532315231;
1253123344421253123;
2312315244412312251;
1233523344431233523;
2312231255512315231;
1253123344431233123;
2312535244412312231;
1233123344421233123;
2812231255512312231;
1833123344421252123;
2812231244432312231;
1833123344431523123;
2812231255512319999;
8888853344421239779;
5555555244412319779;
5555555544431239779;
5555555555555555555;